WWWWWWWWWWWWWWWWWWWWWWWWWWWWWWWW
W..............................W
W.....P........................W
W..............................W
W..............................W
W..............................W
W..............................W
W..............................W
W..............................W
W..............................W
W..............................W
W..............................W
W..........WWWWWWWW............W
W..............................W
W..............................W
W..............................W
W..............................W
W..............................W
W..............................W
W..............................W
W..............................W
W..............................W
W..............................W
WWWWWWWWWWWWWWWWWWWWWWWWWWWWWWWW